...#############
...#........#..#
#..#..#######..#
#.....#........#
####..#######..#
#........#.....#
####..#######..#
#...........#..#
####..#..####..#
#.....#.........
#############...
\robot 0 10
\robot 15 0